111111111111
1P0000000001
100000000001
1C0000000001
10000E000001
111111111111
