111111111111111111111
100C11C11C0000C1000E1
100111011110110110111
1101000110001100100C1
1P0001000010C110001C1
111111111111111111111