11111111111
100C11C11C1
10111101101
10000100001
11110111101
100C0011100
10111011101
10111C11101
1P0000000E1
11111111111